####
#  #########
#    ##    #
# BBB#     #
##...# #BBB#
 #...# #...#
 #BBB  #...##
 #    ##BBB #
 ####### &  #
       ######