###########
#         #
#         #
#  . . .  #
#    B    #
#    B    #
#    B    #
#         #
#    &    #
#         #
###########