####
#  ####
# . . #
# BBX&#
##    #
 ######