########
#  . . #
#    # #
## # # #
 #  B  #
 #  B& #
 #     #
 #######