  ######
  # ..&#
  # BB #
  ## ###
   # #
   # #
#### #
#    ##
# #   #
#   # #
###   #
  #####