##########
#    &   #
#  B  .  #
#        #
##########